....#.....
.........#
..........
..#.......
.......#..
..........
.#.O......
......OO#.
#O........
......#O..
